000000000000000000000000000000000000000000000000000000000000000000000000000000000000000000000000000000000000000000000000000000000000000000000000000000000000000000000000000000000
200000000000000000000000000000000000000000000000000000000000000000000000000000000000000000000000000000000000000000000000000000000000000000000000000000000000000000000000000000000
200000000000000000000000000000000000000000000000000000000000000000000000000000000000000000000000000000000000000000000000000000000000000000000000000000000000000000000000000000000
200000000000000000000000000000000000000000000000000000000000000000000000000000000000000000000000000000000000000000000000000000000000000000000000000000000000000000000000000000000
200000000000000000000000000000000000000000000000000000000000000000000000000000000000000000000000000000000000000000000000000000000000000000000000000000000000000000000000000000000
200000000000000000000000000000000000000000000000000000000000000000000000010000000000000000000000000000000000000000000000000000000000000000000000000000000000000000000000000000000
2000000000000000000000000000000000000000000000000000000000000000000000M0000000000000000000000000000000000000000000000000000000000000000000000000000000000000000000000000000000000
2000000000000000000000000000000000F000000000000000000M000000000000000000000000000000000000000000000000000000000000000000000000000000000000000000000000000000000000000000000000000
200000000000000000000000000000033330000000220000000000078000000000002222220000000000000000000000000000000000000000000000000000000000000000000000000000000000000000000000000000000
2000000000000000000000000000000000000000000300000000000460000000000000000000000000000000000M00000000000000F0000000000000P00000000000000000000000000000000000000020000000000000000
200000000000000000000000133330000000000000030000007800046000022222000000000000000000000000000000000000000020000000000000780000000000000000000000000000000000000220000000000000000
20000J000000000000000000000000000000000000030000004600046000000000000000000000000000000000020000000000000000000000000000460000000000000000000000000000000000002220000000000000000
200000000000000020000000000G0000000000M0000200B000460004600000002000000000Y000000000Y000002200000000000000000000000000004600000000G00000000000G0000000000000022229000000000000000
222222222222222222222222222222222222222222222222222255546555555522222222222222222222222222222222222222222222222222222222222222222222222222222222222222222222222222222222222222222
222222222222222222222222222222222222222222222222222255546555555522222222222222222222222222222222222222222222222222222222222222222222222222222222222222222222222222222222222222222