000000000000000000000000000000000000000000000000000000000000000000000000000000000000000000000000000000000000000000000000000000000000000000000000000000000000000000000000000000000000000000000
200000000000000000000000000000000000000000000000000000000000000000000000000000000000000000000000000000000000000000000000000000000000000000000000000000000000000000000000000000000000000000000
200000000000000000000000000000000000000000000000000000000000000000000000000000000000000000000000000000000000000000000000000000000000000000000000000000000000000000000000000000000000000000000
200000000000000000000000000000000000000000000000000000000000000000000000000000000000000000000000000000000000000000000000000000000000000000000000000000000000000000000000000000000000000000000
200000000000000000000000000020000L00000000000000020000000000000000000000000000000000000000000000000000000000000000000000000000000000000000000000000000000000000000000000000000000000000000000
200000000000000000000000000000000000000000000000000000000000000000000000000000000000000000000000000000000000000000000000000000000000000000000000000000000000000000000000000000000000000000000
200000000000000000000000000000000000000000000000000000000000000000000000000000000000000000000000000000000000000000000000000000000000000000000000000000000000000000000000000000000000000000000
2000000000000000000000000000000000000000000000000000000000000000000000000000000000000000000000000000000000000000000000000000M0000000000000000000000000000000000000000000000000000000000000000
2000000000000000000000000000000000000000000000000000000000000000000000000000000000000000000000000000000000000000000000M0000000078000000000000002000000000000000000000000000000000000000000000
20000000000000000000000000000000000000000000000000M000000P00000001333300000000000000000000000000000000000000000000000000000000046000000000000022000000000000000000000000000000000000000000000
2000000000000000000000000000000000000000000000000000001007800000000000000M0000000000000000000000780000000000000000000000078000046000000000000222000000000000000000000000000000000000000000000
200J0000000000000000000000002000000000M000000000007800000460000000000000000000000000000000000000460000000000000000078000046000046000000000002222000000000000000000000000000000000000000000000
200000000000200G00002000G00220000000000Y00000000004600000460000000000000000000000000000M000000004600000000000K000004600004600004600000B000022222900000000000000000000000000000000000000000000
222222222222222222222222222222222222222222222222222222222222222222222222555222222222222222222222222222222222222222222555546555546222222222222222222222222222222222222222222222222222222222222
222222222222222222222222222222222222222222222222222222222222222222222222555222222222222222222222222222222222222222222555546555546222222222222222222222222222222222222222222222222222222222222