00000000000000000000000000000000000000000000000000000000000000000000000000000000000000000000000000000000000000000000000000000000000000000000000000000000000000000000000000000000000000000000
20000000000000000000000000000000000000000000000000000000000000000000000000000000000000000000000000000000000000000000000000000000000000000000000000000000000000000000000000000000000000000000
20000000000000000000000000000000000000000000000000000000000000000000000000000000000000000000000000000000000000000000000000000000000000000000000000000000000000000000000000000000000000000000
20000000000000000000000000000000000000000000000000000000000000000000000000000000000000000000000000000000000000000000000000000000000000000000000000000000000000000000000000000000000000000000
20000000000000000000000000000000000000000000000000000000000000000000000000000000000000000000000000000000000000000000000000000000000000000000000000000000000000000000000000000000000000000000
20000000000000000000000000000000000000000000000000000000000000000000000000000000000000000000000000000000000000000000000000000000000000000000000000000000000000000000000000000000000000000000
2000000000000000000000000000000000000000000000000000000000000000000000020000L000000000000002000000000000000000000000000000000000000000000000000000000000000000000000000000000000000000000000
2000000000000000000000M000000000000000000000000000000100000000000000000000000000000000000000000000000000000000000000000000000000000000000000000000000000000000000000000000000000000000000000
2000000000000000000000000000000000000000000000000000000000000000000000000000000000000000000000000000000000000000000000000000M000000000000000000000000000000000000000000000000000000000000000
200000000000M0000000233331000000000000000000000000000000000000000M00000000000000000000000000000000000000000000000000000000000000000000000000000000000000000000000000000000000000000000000000
200000000000000000000000000000000000000000000000000000000780000000000000000P000000000000000000000000000001000000000000M0000078000000000000000M00000000000000M00000000000M0000000000000000000
200J0000000020000000000000002000000000M00000000000780000046000000000000200078000000K00000000000078000000000000000000000000004600000000000000000000000000000000000000000000000000000000000000
200000000002200G00000000000222000Y00000Y0000000000460000046000000B000022000460000000000000000000460000G000000G00000G0000000046000000000000000G00000000000000G00000000000G0020000000000009000
22222222222222222222222222222222222222222222222222222222222222222222222255522222222222222222222222222222222222222222222222222222222222222222222222222222222222222222222222222222222222222222
22222222222222222222222222222222222222222222222222222222222222222222222255522222222222222222222222222222222222222222222222222222222222222222222222222222222222222222222222222222222222222222